PreciseLocation.Verbatim	Locality
"'El Roble' at Pasada above Aguadita, elevation 7850 ft."	Los Robles
"Above Caqueza, elevation 6500 feet"	Caqueza
"above Honda, elevation 2700 feet"	El Consuelo
"above Miraflores, Palmira; Valle"	Miraflores
Aguachica	Aguachica
"Aguada, Fusugasuga [Elevation 8500 feet]"	Aguadita
Aguadita	Aguadita
"Aguadita, above Fusugasuga, elevation 6500 feet"	Aguadita
"Aguadita, elevation 6500 feet"	NA
"Aguadita, Fusugasuga"	Aguadita
Algodonal	Algodonal
"Algodonal, Magdalena River"	Algodonal
Almaguer	Almaguer
Alto de Toche	Rio Toche
"Alto del Roble, Bogota; Special District"	Alto del Roble
Andalucia	Andalucia
Anolaima	Anolaima
"Aquadita, Fusugasuga"	Aguadita
Barranquilla	Barranquilla
"Barranquilla, N Magdalena River"	Barranquilla
"Below Miraflores, Portrerillo"	Miraflores
"Bogata Plateau, El Pinon"	El Penon
"Bogata, Tocaimito [Elevation 10600 feet]"	Tocaimito
Bogota; istrito Capital de	Bogota
Buena Vista	Buena Vista
"Buena Vista, altitude 4000 feet"	Buena Vista
"Buena Vista, altitude 4000 feet above Villavicencio"	Buena Vista
"Buena Vista, elevation 4000 feet"	Buena Vista
"Buena Vista, elevation 4200 ft."	Buena Vista
"Buena Vista, Villavicencio"	Buena Vista
Calamar	Calamar
"Calamar, Magdalena R."	Calamar
"Calamar, Magdalena River"	Calamar
"Cali, Cauca Valley"	Cali
"Cali, Cauca Valley, elevation 3500 feet.; Valle"	Cali
"Cali, Cauca Valley; Valle"	Cali
Caqueza	Caqueza
Cartagena	Cartagena
"Cauca Valley, Cali [elevation 3500 feet]; Valle"	Cali
"Cauca Valley, Cali, elevation 3500 feet; Valle"	Cali
"Cauca Valley, Cali,; Valle"	Cali
"Cauca Valley, Cali; Valle"	Cali
"Cauca Valley, Guengue; Valle:Colombia"	_Guengue
"Cauca Valley, Palmira; Valle"	Palmira
"Cauca Valley, San Antonio, near Cali; Valle"	San Antonio
"Central Andes, Ibague"	Ibague
"Central Andes, Laguneta"	Laguneta
"Central Andes, Laguneta [Elevation 9000 feet]"	Laguneta
"Central Andes, near El Eden [Elevation 8000 feet]"	El Eden
"Central Andes, Tochecito River"	Rio Toche
"Central range of Andes, near Finlandia, elevation 6000 feet"	Filandia
"Chicoral, Magadlena River"	Chicoral
"Chicoral, Magdalena Valley"	Chicoral
"Chicoral, on Rio Coello, Magdalena Valley"	Chicoral
Chipague	Chipaque
Chipaque	Chipaque
Choachi	Choachi
Choachi [Elevation 3156 feet]	Choachi
Choachi [Elevation 5850 feet]	Choachi
Choachi [Elevation probably 5800 feet]	Choachi
"Choachi, elevation 3850 feet"	Choachi
"Choachi, elevation 5850 feet"	Choachi
"Don Diego, Santa Marta"	Don Diego
El Consuelo	El Consuelo
"El Consuelo, eastern ridge above Honda"	El Consuelo
"El Consuelo, eastern ridge above Honda; Colombia, Tolima"	El Consuelo
"El Consuelo, Honda, elevation 3000 feet"	El Consuelo
"El Eden, Central Andes"	El Eden
El Penon	El Penon
El Pinon	El Penon
"El Pinon, elevation 9600 feet"	El Penon
"El Pinon, near Bogota, elevation 9600 feet"	El Penon
El Roble	Los Robles
"El Roble, Fusugasuga"	Los Robles
"El Roble, near Fusugasuga"	Los Robles
"El Roble, Posada above Aguada. elevation 7850 feet"	Los Robles
"El Roble, Posada above Aguadita [Elevation 7850 feet]"	Los Robles
El Tigre	
Encononso	_Icononzo
Encononso [Elevation 5850 feet]	_Icononzo
Enconoso	_Icononzo
Escononso	_Icononzo
"Finlandia, Central Andes"	Filandia
Florencia	Florencia
Fomeque	Fomeque
Fomeque [Elevation 5300 feet]	Fomeque
Fundacion	Fundacion
Fusagasuga	Fusagasuga
Fusugasuga	Fusagasuga
Fusugasuga (Aguadita)	Aguadita
"Fusugasuga, (El Roble)"	Los Robles
"Fusugasuga, (elevation 6200 feet)"	Fusagasuga
"Fusugasuga, El Roble"	Los Robles
Gallera	Gallera
"Gamarra, Magdalena R."	Gamarra
"Gamarra, Magdalena River"	Gamarra
Guengue	_Guengue
"Guengue, Cauca Valley"	_Guengue
"Guengue, Cauca Valley, elevation 3600 feet; Valle"	_Guengue
Honda	Honda
"Honda, El Triunfo"	Honda
"Honda, elevation 600 feet"	Honda
"Honda, Magdalena"	Honda
"Honda, Magdalena River"	Honda
"Honda, Magdalena Valley"	Honda
"Ibaque, Magdalena Valley"	Ibague
"Ibaque, Magdalena Valley, altitude 4000 feet"	Ibague
La Manuelita	La Manuelita
"La Manuelita, Palmira, elevation 3500 feet; Valle"	La Manuelita
"La Manuelita, Palmira; Valle"	La Manuelita
La Manuelita; Valle	La Manuelita
"La Marmelita, Palmira, elevation 3500 feet; Valle"	La Manuelita
La Morelia	La Morelia
Laguneta	Laguneta
"Laguneta, Central Andes"	Laguneta
Lagunillas	
"Las Vegas, Santa Martia"	
"Las Ventanas, Santander"	
Los Cisneros	Cisneros
"Magangue, Magdalena River"	_Magangue
"Magdalena Valley, Algodonal"	Algodonal
"Magdalena Valley, Chicoral"	Chicoral
"Magdalena Valley, Honda"	Honda
"Magdalena Valley, Puerto Nino"	Puerto Nino
"Marangue, Magdalena"	Marangue
"Marangue, Magdalena River"	Marangue
Miraflores	Miraflores
"Miraflores, Palmira"	Miraflores
"Miraflores, Palmira, Cauca Valley; Valle"	Miraflores
"Miraflores, Palmira, elevation 6000 feet; Valle"	Miraflores
"Miraflores, Palmira, elevation 6100 ft.; Valle"	Miraflores
"Miraflores, Palmira, elevation 6500 feet; Valle"	Miraflores
"Miraflores, Palmira, elevation 6600 ft.; Valle"	Miraflores
"Miraflores, Palmira, elevation 6800 ft.; Valle"	Miraflores
"Miraflores, Palmira, elevation 7000 ft.; Valle"	Miraflores
"Miraflores, Palmira. Elevation 6200 ft.; Valle"	Miraflores
"Monte Redondo, elevation 4000 feet"	Monteredondo
"Monte Redondo, elevation 4500 feet"	Monteredondo
Monteredondo	Monteredondo
Monterredondo	Monteredondo
"Mount Redondo, elevation 4500 feet"	Monteredondo
"Mouth of Magdalena River, near Barranquilla"	Barranquilla
"Nare, Puerto Berrio"	Puerto Berrio
"Nare, Puerto Nino"	Puerto Nino
near Aguada [Elevation 7850 feet]	Aguadita
near Bogota; Special District	Bogota
"near El Eden, Central Andes"	El Eden
"near Ibague, Magdalena Valley"	Ibague
"near Laguneta, Central Andes, elevation 9000 ft."	Laguneta
Opon	Opon
"Opon, Magdalena Valley"	Opon
"Palmira, Cauca Valley; Valle"	Palmira
"Palmira, Guengue; Valle"	Guengue
"Palmira, La Manuelita, elevation 3500 feet; Valle"	La Manuelita
"Palmira, La Manuelita; Valle"	La Manuelita
"Palmira, Miraflores"	Miraflores
"Palmira, Miraflores [Elevation 6000 feet]; Valle"	Miraflores
"Palmira, Miraflores [Elevation 7800 feet]; Valle"	Miraflores
"Palmira, Miraflores, [elevation 6800 feet]; Valle"	Miraflores
"Palmira, Miraflores, La Tigrera, elevation 7000 ft.; Valle"	Miraflores
"Palmira, Miraflores; Valle"	Miraflores
"Palmira, Portrerillo; Valle"	Miraflores
Palmira; Valle	Palmira
Palmira; Valle del Cauca	Palmira
"Pasada, above Fusugasuga (Aguadita)"	Aguadita
Pie de San Juan	
"Pie de San Juan, Central Andes, elevation 6500 feet"	
"Pied de San Juan, Central Andes"	
Portrerillo	Miraflores
"Portrerillo, Miraflores"	Miraflores
"Portrerillo, Palmira; Valle"	Miraflores
"Posada on W slope of E Cordillera, Fusugasuga  [Elevation 8500 feet]"	El Penon
Puerto Berrio	Puerto Berrio
"Puerto Berrio, Magdalena River"	Puerto Berrio
Quetame	Quetame
"Quetame, elevation 4800 ft."	Quetame
"Quindio Pass, Central Andes"	Laguneta
Remolino	Remolino
"Remolino, 15 miles above Gamarra"	Remolino
Rio Caqueta	Rio Caqueta
"Rio Cauca, Tierre Blanca"	Tierre Blanca
Rio Chuari	
Rio Vidos	
San Agustin	San Agustin
San Antonio	San Antonio
San Antonio [Elevation 6200 feet]	San Antonio
San Antonio [Elevation 6600 feet]	San Antonio
"San Antonio, aqltitude 6600 feey"	San Antonio
"San Antonio, elevation 4000 feet"	San Antonio
"San Antonio, elevation 6400 feet"	San Antonio
"San Antonio, elevation 6600 feet"	San Antonio
"San Antonio, elevation 6600 ft."	San Antonio
San Antonio; Norino	San Antonio
"San Jose, elevation 200 ft."	San Jose
"Santa Isabel, near Banco"	Banco
"Santa Marta Mountains, Cincinnati"	
Santander	
Tocaimito	Tocaimito
"Tocaimito, above Bogota"	Tocaimito
"Tochecito River, Central Andes"	Rio Toche
Villavicencio	Villavicencio
"Villavicencio, altitude 1800 feet"	Villavicencio
"Villavicencio, altitude 2000 feet"	Villavicencio
"Villavicencio, elevation 1800 feet"	Villavicencio
"Villavicencio, elevation 1800 ft."	Villavicencio
"Volcancito, Central Andes, elevation 10,800 ft."	Rio Toche
"Western Colombia, Buenavista"	Buenavista