Chapman	Clements	Notes
Tinamus tao	Tinamus tao	NA
Tinamus major ruficeps	Tinamus major	NA
Tinamus major castaneiceps	Tinamus major	NA
Tinamus major latifrons	Tinamus major	NA
Nothocercus julius	Nothocercus julius	NA
Nothocercus bonapartei	Nothocercus bonapartei	NA
Crypturus cinereus	Crypturellus cinereus	NA
Crypturus berlepschi	Crypturellus berlepschi	NA
Crypturus soui soui	Crypturellus soui	NA
Crypturus soui caucae	Crypturellus soui	NA
Crypturus soui modestus	Crypturellus soui	NA
Crypturus soui caquetae	Crypturellus soui	NA
Crypturus adspersus yapura	Crypturellus undulatus	NA
Crypturus variegatus salvini	Crypturellus variegatus	NA
Crypturus kerriae	Crypturellus kerriae	NA
Crax alector	Crax alector	NA
Crax panamensis	Crax rubra	NA
Crax alberti	Crax alberti	NA
Penelope montagni	Penelope montagnii	NA
Penelope ortoni	Penelope ortoni	NA
Penelope cristata	Penelope purpurascens	NA
Penelope perspicax	Penelope perspicax	NA
Penelope jacquacu	Penelope jacquacu	NA
Ortalis columbiana columbiana	Ortalis columbiana	NA
Ortalis columbiana caucae	Ortalis columbiana	NA
Ortalis guttata	Ortalis guttata	NA
Ortalis garrula	Ortalis garrula	NA
Pipile cumanensis	Pipile cumanensis	NA
Aburria aburri	Aburria aburri	NA
Chamaepetes goudoti goudoti	Chamaepetes goudotii	NA
Colinus cristatus decoratus	Colinus cristatus	NA
Colinus cristatus leucotis	Colinus cristatus	NA
Colinus cristatus parvicristatus	Colinus cristatus	NA
Odontophorus guianensis marmoratus	Odontophorus gujanensis	NA
Odontophorus hyperythrus	Odontophorus hyperythrus	NA
Odontophorus parambae	Odontophorus erythrops	NA
Odontophorus strophium	Odontophorus strophium	NA
Rhynchortyx cinctus australis	Rhynchortyx cinctus	NA
Columba speciosa	Patagioenas speciosa	NA
Columba rufina	Patagioenas cayennensis	NA
Columba goodsoni	Patagioenas goodsoni	NA
Columba albilinea albilinea	Patagioenas fasciata	NA
Columba plumbea propinqua	Patagioenas plumbea	NA
Columba subvinacea bogotensis	Patagioenas subvinacea	NA
Columba subvinacea berlepschi	Patagioenas subvinacea	NA
Zenaida auriculata	Zenaida auriculata	NA
Zenaida ruficauda ruficauda	Zenaida auriculata	NA
Zenajda ruficauda robinsoni	Zenaida auriculata	NA
Zenaida ruficauda antioquiae	Zenaida auriculata	NA
Chaemepelia passerina albivitta	Columbina passerina	NA
Chaemepelia passerina parvula	Columbina passerina	NA
Chaemepelia passerina nana	Columbina passerina	NA
Chaemepelia minuta elaeodes	Columbina minuta	NA
Chaemepelia rufipennis rufipennis	Columbina talpacoti	NA
Chaemepelia rufipennis caucae	Columbina talpacoti	NA
Claravis pretiosa livida	Claravis pretiosa	NA
Leptotila verreauxi verreauxi	Leptotila verreauxi	NA
Leptotila verreauxi occidentalis	Leptotila verreauxi	NA
Leptotila rufaxilla dubusi	Leptotila rufaxilla	NA
Leptotila rufaxilla pallidipectus	Leptotila rufaxilla	NA
Leptotila plumbeiceps	Leptotila plumbeiceps	NA
Leptotila pallida	Leptotila pallida	NA
Leptotila cassini	Leptotila cassinii	NA
Osculatia purpurata	Geotrygon purpurata	NA
Oreopeleia montana	Geotrygon montana	NA
Oreopeleia veraguensis	Leptotrygon veraguensis	NA
Oreopeleia bourcieri	Zentrygon frenata	NA
Oreopeleia linearis linearis	Zentrygon linearis	NA
Opisthocomus hoazin	Opisthocomus hoazin	NA
Rallus semiplumbeus	Rallus semiplumbeus	NA
Pardirallus nigricans nigricans	Pardirallus nigricans	NA
Aramides cajanea cajanea	Aramides cajaneus	NA
Amaurolimnas concolor guatemalensis	Amaurolimnas concolor	NA
Anurolimnas castaneiceps	Anurolimnas castaneiceps	NA
Anurolimnas hauxwelli	Anurolimnas fasciatus	NA
Porzana carolina	Porzana carolina	NA
Porzana flaviventris	Hapalocrex flaviventer	NA
Creciscus aenops	Laterallus albigularis	NA
Creciscus albigularis	Laterallus albigularis	NA
Neocrex colombianus	Mustelirallus colombianus	NA
Gallinula chloropus pauxilla	Gallinula chloropus	NA
Porphyriops melanops bogotensis	Porphyriops melanops	NA
Ionornis martinicus	Porphyrio martinica	NA
Fulica americana columbiana	Fulica americana	NA
Heliornis fulica	Heliornis fulica	NA
Colymbus dominicus brachyrhynchus	Tachybaptus dominicus	NA
Podilymbus podiceps	Podilymbus podiceps	NA
Phaetusa chloropoda	Phaetusa simplex	NA
Belonopterus cayennensis	Vanellus chilensis	NA
Charadrius dominicus dominicus	Pluvialis dominica	NA
Aegialitis semipalmata	Charadrius semipalmatus	NA
Aegialitis collaris	Charadrius collaris	NA
Himantopus mexicanus	Himantopus mexicanus	NA
Totanus melanoleucus	Tringa melanoleuca	NA
Totanus flavipes	Tringa flavipes	NA
Helodromas solitarius solitarius	Tringa solitaria	NA
Actitis macularia	Actitis macularius	NA
Tringa minutilla	Calidris minutilla	NA
Pisobia maculata	Calidris melanotos	NA
Gallinago delicata	Gallinago delicata	NA
Gallinago braziliensis	Gallinago paraguaiae	NA
Gallinago nobilis	Gallinago nobilis	NA
Gallinago jamesoni	Gallinago jamesoni	NA
Jacana spinosa	Jacana jacana	NA
Jacana melanopygia	Jacana jacana	NA
Jacana nigra	Jacana jacana	NA
Burhinus bistriatus	Burhinus bistriatus	NA
Eurypyga major	Eurypyga helias	NA
Psophia napensis	Psophia crepitans	NA
Theristicus caudatus	Theristicus caudatus	NA
Harpiprion cayennensis	Mesembrinibis cayennensis	NA
Phimosus berlepschi	Phimosus infuscatus	NA
Ajaia ajaja	Platalea ajaja	NA
Jabiru mycteria	Jabiru mycteria	NA
Ardea cocoi	Ardea cocoi	NA
Herodias egretta	Ardea alba	NA
Florida caerulea	Egretta caerulea	NA
Hydranassa tricolor tricolor	Egretta tricolor	NA
Agamia agami	Agamia agami	NA
Nycticorax nycticorax naevius	Nycticorax nycticorax	NA
Cochlearius cochlearius	Cochlearius cochlearius	NA
Pilherodias pileatus	Pilherodius pileatus	NA
Butorides striata	Butorides striata	NA
Tigrisoma lineatum	Tigrisoma lineatum	NA
Tigrisoma salmoni	Tigrisoma fasciatum	NA
Ixobrychus erythromelas	Ixobrychus exilis	NA
Ixobrychus exilis bogotensis	Ixobrychus exilis	NA
Palamedea cornuta	Anhima cornuta	NA
Cairina moschata	Cairina moschata	NA
Dendrocygna bicolor	Dendrocygna bicolor	NA
Dendrocygna discolor	Dendrocygna autumnalis	NA
Nettion andium	Anas andium	NA
Querquedula discors	Spatula discors	NA
Querquedula cyanoptera	Spatula cyanoptera	NA
Marila nationi	Netta erythrophthalma	NA
Marila affinis	Aythya affinis	NA
Nomonyx dominicus	Nomonyx dominicus	NA
Merganetta colombiana	Merganetta armata	NA
Phalacrocorax vigua vigua	Phalacrocorax brasilianus	NA
Catharista urubu	Coragyps atratus	NA
Cathartes aura aura	Cathartes aura	NA
Polyborus cheriway	Caracara cheriway	NA
Ibycter americanus	Ibycter americanus	NA
Milvago chimachima	Milvago chimachima	NA
Circus hudsonius	Circus hudsonius	NA
Circus cinereus	Circus cinereus	NA
Circus buffoni	Circus buffoni	NA
Micrastur guerilla interstes	Micrastur ruficollis	NA
Parabuteo unicinctus harrisi	Parabuteo unicinctus	NA
Accipiter superciliosus	Accipiter superciliosus	NA
Accipiter ventralis	Accipiter striatus	NA
Accipiter bicolor	Accipiter bicolor	NA
Tachytriorchis albicaudatus exiguus	Geranoaetus albicaudatus	NA
Buteo hypospodius	Geranoaetus polyosoma	"B. hypospodius is a synonym of G. albicaudatus. This specimen was taken from the paramo zone of Nevados de Tolima, so is more likely to be G. polyosoma "
Buteo platypterus	Buteo platypterus	NA
Buteo brachyurus	Buteo brachyurus	NA
Asturina nitida	Buteo nitidus	NA
Rupornis magnirostris magnirostris	Rupornis magnirostris	NA
Rupornis magnirostris ruficauda	Rupornis magnirostris	NA
Busarellus nigricollis	Busarellus nigricollis	NA
Urubitinga urubitinga	Buteogallus urubitinga	NA
Urubitinga schistacea	Buteogallus schistaceus	NA
Urubitinga plumbea	Cryptoleucopteryx plumbea	NA
Leucopternis semiplumbea	Leucopternis semiplumbeus	NA
Lophotriorchis isidori	Spizaetus isidori	NA
Spizaetus ornatus	Spizaetus ornatus	NA
Spizaetus tyrannus	Spizaetus tyrannus	NA
Herpetotheres cachinnans cachinnans	Herpetotheres cachinnans	NA
Herpetotheres cachinnans fulvescens	Herpetotheres cachinnans	NA
Elanoides forficatus yetapa	Elanoides forficatus	NA
Rostrhamphus sociabilis	Rostrhamus sociabilis	NA
Leptodon uncinatus	Chondrohierax uncinatus	NA
Leptodon palliatus	Leptodon cayanensis	NA
Harpagus bidentatus	Harpagus bidentatus	NA
Ictinia plumbea	Ictinia plumbea	NA
Falco fusco-caerulescens	Falco femoralis	NA
Falco rufigularis	Falco rufigularis	NA
Cerchneis sparveria caucae	Falco sparverius	NA
Cerchneis sparveria intermedia	Falco sparverius	NA
Cerchneis sparveria	Falco sparverius	NA
Asio flammeus bogotensis	Asio flammeus	NA
Asio stygius	Asio stygius	NA
Otus choliba	Megascops choliba	NA
Otus watsoni	Megascops watsonii	NA
Lophostrix cristatus stricklandi	Lophostrix cristata	NA
Ciccaba albitarsus	Ciccaba albitarsis	NA
Ciccaba albogularis	Megascops albogularis	NA
Ciccaba virgata virgata	Ciccaba virgata	NA
Ciccaba nigrolineata	Ciccaba nigrolineata	NA
Glaucidium brasilianum brasilianum	Glaucidium brasilianum	NA
Glaucidium brasilianum phalaenoides	Glaucidium brasilianum	NA
Glaucidium jardini	Glaucidium jardinii	NA
Tyto perlata	Tyto alba	NA
Ara ararauna	Ara ararauna	NA
Ara macao	Ara macao	NA
Ara chloroptera	Ara chloropterus	NA
Ara militaris militaris	Ara militaris	NA
Ara severa	Ara severus	NA
Aratinga wagleri	Psittacara wagleri	NA
Aratinga aeruginosa aeruginosa	Eupsittula pertinax	NA
Ognorhynchus icterotis	Ognorhynchus icterotis	NA
Pyrrhura calliptera	Pyrrhura calliptera	NA
Pyrrhura melanura pacifica	Pyrrhura melanura	NA
Pyrrhura souancei	Pyrrhura melanura	NA
Psittacula conspicillata conspicillata	Forpus conspicillatus	NA
Psittacula conspicillata caucae	Forpus conspicillatus	NA
Psittacula sclateri	Forpus modestus	NA
Psittacula spengeli	Forpus xanthopterygius	NA
Brotogeris jugularis	Brotogeris jugularis	NA
Brotogeris devillei	Brotogeris cyanoptera	NA
Amazona inornata	Amazona farinosa	NA
Amazona mercenaria	Amazona mercenarius	NA
Amazona amazonica	Amazona amazonica	NA
Amazona ochrocephala ochrocephala	Amazona ochrocephala	NA
Amazona ochrocephala panamensis	Amazona ochrocephala	NA
Amazona salvini	Amazona autumnalis	NA
Pionus menstruus	Pionus menstruus	NA
Pionus seniloides seniloides	Pionus tumultuosus	NA
Pionus chalcopterus	Pionus chalcopterus	NA
Hapalopsittaca amazonina	Hapalopsittaca amazonina	NA
Hapalopsittaca fuertesi	Hapalopsittaca fuertesi	NA
Eucinetus pulchra	Pyrilia pulchra	NA
Pyrilia pyrilia	Pyrilia pyrilia	NA
Pionites melanocephala pallidus	Pionites melanocephalus	NA
Megaceryle torquata torquata	Megaceryle torquata	NA
Chloroceryle amazona	Chloroceryle amazona	NA
Chloroceryle americana americana	Chloroceryle americana	NA
Chloroceryle inda	Chloroceryle inda	NA
Urospatha martii martii	Baryphthengus martii	NA
Urospatha martii semirufa	Baryphthengus martii	NA
Electron platyrhynchus platyrhynchus	Electron platyrhynchum	NA
Electron platyrhynchus pyrrholaemus	Electron platyrhynchum	NA
Electron platyrhynchus minor	Electron platyrhynchum	NA
Momotus subrufescens subrufescens	Momotus subrufescens	NA
Momotus subrufescens reconditus	Momotus subrufescens	NA
Momotus momota ignobilis	Momotus momota	NA
Momotus aequatorialis aequatorialis	Momotus aequatorialis	NA
Hylomanes momotula obscurus	Hylomanes momotula	NA
Nyctibius longicaudatus	Nyctibius aethereus	NA
Chordeiles acutipennis acutipennis	Chordeiles acutipennis	NA
Chordeiles acutipennis texensis	Chordeiles acutipennis	NA
Lurocalis rufiventris	Lurocalis rufiventris	NA
Uropsalis lyra	Uropsalis lyra	NA
Hydropsalis climacocerca	Hydropsalis climacocerca	NA
Nyctidromus albicollis albicollis	Nyctidromus albicollis	NA
Thermochalcis cayennensis cayennensis	Hydropsalis cayennensis	NA
Thermochalcis cayennensis monticola	Hydropsalis cayennensis	NA
Thermochalcis ruficervix	Systellura longirostris	NA
Antrostomus rosenbergi	Nyctiphrynus rosenbergi	NA
Streptoprocne zonaris altissima	Streptoprocne zonaris	NA
Streptoprocne zonaris albicincta	Streptoprocne zonaris	NA
Chaetura spinicauda fumosa	Chaetura spinicaudus	NA
Chaetura cinereiventris sclateri	Chaetura cinereiventris	NA
Chaetura cinereiventris occidentalis	Chaetura cinereiventris	NA
Cypseloides brunneitorques brunneitorques	Streptoprocne rutila	NA
Doryfera ludoviciae ludoviciae	Doryfera ludovicae	NA
Androdon aequatorialis	Androdon aequatorialis	NA
Threnetes cervinicauda	Threnetes leucurus	NA
Threnetes ruckeri fraseri	Threnetes ruckeri	NA
Glaucis hirsuta affinis	Glaucis hirsutus	NA
Glaucis aenea	Glaucis aeneus	NA
Phaethornis guyi emiliae	Phaethornis guy	NA
Phaethornis yaruqui sancti-johannis	Phaethornis yaruqui	NA
Phaethornis fraterculus moorei	Phaethornis malaris	NA
Phaethornis hispidus oseryi	Phaethornis hispidus	NA
Phaethornis syrmatophorus syrmatophorus	Phaethornis syrmatophorus	NA
Phaethornis syrmatophorus columbianus	Phaethornis syrmatophorus	NA
Phaethornis anthophilus	Phaethornis anthophilus	NA
Phaethornis griseogularis	Phaethornis griseogularis	NA
Phaethornis striigularis striigularis	Phaethornis striigularis	NA
Phaethornis striigularis subrufescens	Phaethornis striigularis	NA
Eutoxeres condaminii	Eutoxeres condamini	NA
Eutoxeres aquila aquila	Eutoxeres aquila	NA
Eutoxeres aquila salvini	Eutoxeres aquila	NA
Eutoxeres aquila heterura	Eutoxeres aquila	NA
Campylopterus obscurus aequatorialis	Campylopterus largipennis	NA
Campylopterus falcatus	Campylopterus falcatus	NA
Florisuga mellivora mellivora	Florisuga mellivora	NA
Agyrtria viridiceps	Amazilia franciae	NA
Agyrtrina viridissima		NA
Agyrtrina fluvialitis	Amazilia fimbriata	NA
Polyerata amabilis	Amazilia amabilis	NA
Polyerata rosenbergi	Amazilia rosenbergi	NA
Uranomitra franciae	Amazilia franciae	NA
Lepidopyga goudoti	Lepidopyga goudoti	NA
Lepidopyga coelina	Lepidopyga coeruleogularis	NA
Saucerottia saucerottei	Amazilia saucerottei	NA
Saucerottia viridigaster	Amazilia viridigaster	NA
Amizilis tzacatl tzacatl	Amazilia tzacatl	NA
Amizilis tzacatl jucunda	Amazilia tzacatl	NA
Hylocharis grayi	Hylocharis grayi	NA
Hylocharis humboldti	Hylocharis humboldtii	NA
Damophila juliae juliae	Juliamyia julie	NA
Chlorostilbon gibsoni	Chlorostilbon gibsoni	NA
Chlorostilbon haeberlini	Chlorostilbon gibsoni	NA
Chlorostilbon melanorhynchus	Chlorostilbon melanorhynchus	NA
Chlorostilbon poortmani poortmani	Chlorostilbon poortmani	NA
Thalurania fannyi fannyi	Thalurania colombica	NA
Thalurania fannyi verticeps	Thalurania colombica	NA
Thalurania nigrofasciata	Thalurania furcata	NA
Thalurania colombica colombica	Thalurania colombica	NA
Chalybura buffoni buffoni	Chalybura buffonii	NA
Chalybura caeruleogaster	Chalybura buffonii	NA
Chalybura urochrysa	Chalybura urochrysia	NA
Colibri delphinae	Colibri delphinae	NA
Colibri cyanotus	Colibri cyanotus	NA
Colibri iolata	Colibri coruscans	NA
Anthracothorax nigricollis nigricollis	Anthracothorax nigricollis	NA
Chrysolampis elatus	Chrysolampis mosquitus	NA
Simonula berlepschi	Anthocephala berlepschi	NA
Phaiolaima rubinoides rubinoides	Heliodoxa rubinoides	NA
Phaiolaima rubinoides aequatorialis	Heliodoxa rubinoides	NA
Heliodoxa leadbeateri	Heliodoxa leadbeateri	NA
Helianthea helianthea	Coeligena helianthea	NA
Helianthea bonapartei	Coeligena bonapartei	NA
Helianthea lutetiae lutetiae	Coeligena lutetiae	NA
Helianthea torquata	Coeligena torquata	NA
Helianthea coeligena columbiana	Coeligena coeligena	NA
Helianthea coeligena ferruginea	Coeligena coeligena	NA
Lafresnayea lafresnayi	Lafresnaya lafresnayi	NA
Lafresnayea saul saul	Lafresnaya lafresnayi	NA
Ensifera ensifera ensifera	Ensifera ensifera	NA
Pterophanes temmincki	Pterophanes cyanopterus	NA
Aglaeactis cupripennis cupripennis	Aglaeactis cupripennis	NA
Boissonneaua jardini	Boissonneaua jardini	NA
Boissonneaua flavescens flavescens	Boissonneaua flavescens	NA
Vestipedes vestitus vestitus	Eriocnemis vestita	NA
Vestipedes vestitus smaragdinipectus	Eriocnemis vestita	NA
Vestipedes paramillo	Eriocnemis vestita	NA
Vestipedes mosquera	Eriocnemis mosquera	NA
Vestipedes aureliae aureliae	Haplophaedia aureliae	NA
Vestipedes aureliae caucensis	Haplophaedia aureliae	NA
Vestipedes derbyi longirostris	Eriocnemis derbyi	NA
Ocreatus underwoodi underwoodi	Ocreatus underwoodii	NA
Urosticte benjamini benjamini	Urosticte benjamini	NA
Adelomyia melanogenys melanogenys	Adelomyia melanogenys	NA
Adelomyia melanogenys cervina	Adelomyia melanogenys	NA
Heliangelus exortis	Heliangelus exortis	NA
Metallura williami	Metallura williami	NA
Metallura tyrianthina tyrianthina	Metallura tyrianthina	NA
Oxypogon stubeli	Oxypogon stuebelii	NA
Chalcostigma herrani	Chalcostigma herrani	NA
Chalcostigma heteropogon	Chalcostigma heteropogon	NA
Ramphomicron microhynchum	Ramphomicron microrhynchum	NA
Opisthroprora euryptera	Opisthoprora euryptera	NA
Cyanolesbia kingi kingi	Aglaiocercus kingii	NA
Cyanolesbia emmae	Aglaiocercus kingii	NA
Cyanolesbia mocoa mocoa	Aglaiocercus kingii	NA
Cyanolesbia coelestis	Aglaiocercus coelestis	NA
Psalidoprymna victoriae victoriae	Lesbia victoriae	NA
Psalidoprymna gouldi gouldi	Lesbia nuna	NA
Schistes geoffroyi	Schistes geoffroyi	NA
Schistes albogularis	Schistes albogularis	NA
Heliothryx barroti	Heliothryx barroti	NA
Anthoscenus longirostris stewartae	Heliomaster longirostris	NA
Calliphlox mitchelli	Philodice mitchellii	NA
Chaetocercus mulsanti	Chaetocercus mulsant	NA
Chaetocercus heliodor	Chaetocercus heliodor	NA
Klais guimete	Klais guimeti	NA
Popelairia conversi	Discosura conversii	NA
Pharomachrus antisiensis	Pharomachrus antisianus	NA
Pharomachrus auriceps	Pharomachrus auriceps	NA
Pharomachrus pavoninus	Pharomachrus pavoninus	NA
Trogonurus personatus	Trogon personatus	NA
Trogonurus assimilis	Trogon personatus	NA
Trogonurus collaris	Trogon collaris	NA
Trogonurus curucui cupreicauda	Trogon rufus	NA
Trogonurus bolivianus	Trogon curucui	NA
Trogon strigilatus strigilatus	Trogon viridis	NA
Trogon strigilatus chionurus	Trogon chionurus	NA
Chrysotrogon caligatus columbianus	Trogon caligatus	NA
Chrysotrogon ramonianus	Trogon ramonianus	NA
Curucujus melanurus melanurus	Trogon melanurus	NA
Curucujus melanurus macrourus	Trogon melanurus	NA
Curucujus massena australis	Trogon massena	NA
Coccyzus melacoryphus	Coccyzus melacoryphus	NA
Coccyzus americanus americanus	Coccyzus americanus	NA
Piaya cayana columbiana	Piaya cayana	NA
Piaya cayana nigricrissa	Piaya cayana	NA
Piaya cayana mesura	Piaya cayana	NA
Piaya rutila rutila	Coccycua minuta	NA
Piaya rutila gracilis	Coccycua minuta	NA
Neomorphus salvini	Neomorphus geoffroyi	NA
Tapera naevia	Tapera naevia	NA
Crotophaga ani	Crotophaga ani	NA
Crotophaga major	Crotophaga major	NA
Capito aurovirens	Capito aurovirens	NA
Capito maculicoronatus rubrilateralis	Capito maculicoronatus	NA
Capito maculicoronatus pirrensis	Capito maculicoronatus	NA
Capito squamatus	Capito squamatus	NA
Capito hypoleucus	Capito hypoleucus	NA
Capito quinticolor	Capito quinticolor	NA
Capito auratus auratus	Capito auratus	NA
Eubucco richardsoni granadensis	Eubucco richardsoni	NA
Eubucco bourcieri bourcieri	Eubucco bourcierii	NA
Eubuceo bourcieri occidentalis	Eubucco bourcierii	NA
Semnornis ramphastinus	Semnornis ramphastinus	NA
Ramphastos piscivorus brevicarinatus	Ramphastos sulfuratus	NA
Ramphastos swainsoni	Ramphastos ambiguus	NA
Ramphastos ambiguus ambiguus	Ramphastos ambiguus	NA
Ramphastos ambiguus abbreviatus	Ramphastos ambiguus	NA
Ramphastos cuvieri	Ramphastos tucanus	NA
Ramphastos culminatus	Ramphastos vitellinus	NA
Ramphastos citreolaemus	Ramphastos vitellinus	NA
Andigena hypoglaucus	Andigena hypoglauca	NA
Andigena nigrirostris nigrirostris	Andigena nigrirostris	NA
Andigena nigrirostris spilorhynchus	Andigena nigrirostris	NA
Andigena nigrirostris occidentalis	Andigena nigrirostris	NA
Pteroglossus pluricinctus	Pteroglossus pluricinctus	NA
Pteroglossus castanotis castanotis	Pteroglossus castanotis	NA
Pteroglossus torquatus nuchalis	Pteroglossus torquatus	NA
Pteroglossus sanguineus	Pteroglossus torquatus	NA
Pteroglossus flavirostris flavirostris	Pteroglossus azara	NA
Pteroglossus humboldti	Pteroglossus inscriptus	NA
Selinidera reinwardti	Selenidera reinwardtii	NA
Selinidera spectabilis	Selenidera spectabilis	NA
Aulacorhynchus albivitta albivitta	Aulacorhynchus albivitta	NA
Aulacorhynchus albivitta phaeolaemus	Aulacorhynchus albivitta	NA
Aulacorhynchus albivitta griseigularis	Aulacorhynchus albivitta	NA
Aulacorhynchus haematopygius	Aulacorhynchus haematopygus	NA
Galbula ruficauda ruficauda	Galbula ruficauda	NA
Galbula ruficauda pallens	Galbula ruficauda	NA
Galbula melanogenia	Galbula ruficauda	NA
Galbula tombacea tombacea	Galbula tombacea	NA
Galbula albirostris chalcocephala	Galbula albirostris	NA
Brachygalba fulviventris fulviventris	Brachygalba lugubris	NA
Brachygalba fulviventris caquetae	Brachygalba lugubris	NA
Galbalcyrhynchus leucotis	Galbalcyrhynchus leucotis	NA
Bucco capensis	Bucco capensis	NA
Notharcus hyperrhynchus leucocrissus	Notharchus hyperrhynchus	NA
Notharcus pectoralis	Notharchus pectoralis	NA
Notharcus tectus subtectus	Notharchus tectus	NA
Argicus macrodactylus	Bucco macrodactylus	NA
Nystactes noanamae	Bucco noanamae	NA
Hypnelus ruficollis ruficollis	Hypnelus ruficollis	NA
Nystalus radiatus	Nystalus radiatus	NA
Malacoptila fusca	Malacoptila fusca	NA
Malacoptila mystacalis	Malacoptila mystacalis	NA
Malacoptila panamensis poliopis	Malacoptila panamensis	NA
Malacoptila panamensis panamensis	Malacoptila panamensis	NA
Micromonacha lanceolata	Micromonacha lanceolata	NA
Nonnula frontalis	Nonnula frontalis	NA
Monasa flavirostris	Monasa flavirostris	NA
Monasa morphoeus peruana	Monasa morphoeus	NA
Monasa pallescens pallescens	Monasa morphoeus	NA
Monasa pallescens sclateri	Monasa morphoeus	NA
Monasa nigrifrons	Monasa nigrifrons	NA
Hypoxanthus rivolii rivolii	Colaptes rivolii	NA
Hypoxanthus rivolii brevirostris	Colaptes rivolii	NA
Chloronerpes xanthochlorus	Piculus chrysochloros	NA
Chloronerpes litae	Piculus litae	NA
Chloronerpes rubiginosus gularis	Colaptes rubiginosus	NA
Chloronerpes rubiginosus buenavistae	Colaptes rubiginosus	NA
Chrysoptilus punctigula guttatus	Colaptes punctigula	NA
Chrysoptilus punctigula punctipectus	Colaptes punctigula	NA
Chrysoptilus punctigula ujhelyii	Colaptes punctigula	NA
Chrysoptilus punctigula striatigularis	Colaptes punctigula	NA
Melanerpes flavigula	Melanerpes formicivorus	NA
Melanerpes cruentatus	Melanerpes cruentatus	NA
Melanerpes pucherani pucherani	Melanerpes pucherani	NA
Melanerpes rubricapillus rubricapillus	Melanerpes rubricapillus	NA
Veniliornis oleaginus fumigatus	Dryobates fumigatus	NA
Veniliornis oleaginus aureus	Dryobates fumigatus	NA
Veniliornis nigriceps equifasciatus	Dryobates nigriceps	NA
Veniliornis dignus	Dryobates dignus	NA
Veniliornis fidelis	Dryobates passerinus	NA
Veniliornis ruficeps haematostigma	Dryobates affinis	NA
Veniliornis kirki cecilii	Dryobates kirkii	NA
Celeus loricatus loricatus	Celeus loricatus	NA
Celeus loricatus mentalis	Celeus loricatus	NA
Campephilus rubricollis	Campephilus rubricollis	NA
Campephilus melanoleucus	Campephilus melanoleucos	NA
Campephilus malherbii	Campephilus melanoleucos	NA
Campephilus pollens	Campephilus pollens	NA
Cniparchus haematogaster splendens	Campephilus haematogaster	NA
Ceophloeus lineatus mesorhynchus	Dryocopus lineatus	NA
Picumnus cinnamomeus	Picumnus cinnamomeus	NA
Picumnus squamulatus squamulatus	Picumnus squamulatus	NA
Picumnus olivaceus olivaceus	Picumnus olivaceus	NA
Picumnus olivaceus harterti	Picumnus olivaceus	NA
Picumnus granadensis granadensis	Picumnus granadensis	NA
Picumnus granadensis antioquensis	Picumnus granadensis	NA
Scytalopus niger	Scytalopus sp.	corresponds to multiple species of the temperate zone
Scytalopus canus	Scytalopus canus	NA
Scytalopus griseicollis	Scytalopus griseicollis	NA
Scytalopus sylvestris	Scytalopus ?spillmanni?	NA
Scytalopus micropterus micropterus	Scytalopus micropterus	NA
Scytalopus infasciatus	Scytalopus griseicollis	NA
Myornis senilis	Myornis senilis	NA
Acropternis orthonyx	Acropternis orthonyx	NA
Conopophaga aurita	Conopophaga aurita	NA
Conopophaga castaneiceps castaneiceps	Conopophaga castaneiceps	NA
Conopophaga castaneiceps chocoensis	Conopophaga castaneiceps	NA
Cymbilaimus lineatus lineatus	Cymbilaimus lineatus	NA
Cymbilaimus lineatus fasciatus	Cymbilaimus lineatus	NA
Taraba unduliger	Taraba major	NA
Taraba transandeana transandeana	Taraba major	NA
Taraba transandeana granadensis	Taraba major	NA
Thamnophilus unicolor	Thamnophilus unicolor	NA
Thamnophilus nigriceps	Thamnophilus nigriceps	NA
Thamnophilus punctatus punctatus	Thamnophilus punctatus	NA
Thamnophilus punctatus atrinucha	Thamnophilus atrinucha	NA
Thamnophilus canadensis pulchellus	Sakesphorus canadensis	NA
Thamnophilus doliatus doliatus	Thamnophilus doliatus	NA
Thamnophilus radiatus albicans	Thamnophilus doliatus	NA
Thamnophilus tenuipunctatus	Thamnophilus tenuepunctatus	NA
Thamnophilus multistriatus	Thamnophilus multistriatus	NA
Thamnistes aequatorialis	Thamnistes anabatinus	NA
Thamnistes anabatinus intermedius	Thamnistes anabatinus	NA
Clytoctantes alixii	Clytoctantes alixii	NA
Dysithamnus semicinereus semicinereus	Dysithamnus mentalis	NA
Dysithamnus semicinereus extremus	Dysithamnus mentalis	NA
Dysithamnus mentalis	Dysithamnus mentalis	NA
Dysithamnus puncticeps flemmingi	Dysithamnus puncticeps	NA
Dysithamnus puncticeps puncticeps	Dysithamnus puncticeps	NA
Dysithamnus leucostictus	Dysithamnus leucostictus	NA
Dysithamnus capitalis capitalis	Thamnophilus schistaceus	NA
Dysithamnus ardesiacus ardesiacus	Thamnomanes ardesiacus	NA
Thamnomanes glaucus	Thamnomanes caesius	NA
Myrmotherula pygmaea	Myrmotherula brachyura	specimens from pacific likely correspond to ignota
Myrmotherula surinamensis pacifica	Myrmotherula pacifica	NA
Myrmopagis fulviventris	Epinecrophylla fulviventris	NA
Myrmopagis haemnatonota	Epinecrophylla haematonota	NA
Myrmopagis ornata ornata	Epinecrophylla ornata	NA
Myrmopagis axillaris melaena	Myrmotherula axillaris	NA
Myrmopagis axillaris albigula	Myrmotherula axillaris	NA
Myrmopagis schisticolor schisticolor	Myrmotherula schisticolor	NA
Myrmopagis schisticolor interior	Myrmotherula schisticolor	NA
Myrmopagis cinereiventris pallida	Myrmotherula menetriesii	NA
Herpsilochmus rufomarginatus frater	Herpsilochmus rufimarginatus	NA
Microrhopias grisea intermedia	Formicivora grisea	NA
Microrhopias boucardi consobrina	Microrhopias quixensis	NA
Drymophila caudata caudata	Drymophila caudata	NA
Terenura callinota	Euchrepomis callinota	NA
Ramphocaenus melanurus trinitatis	Ramphocaenus melanurus	NA
Ramphocaenus rufiventris griseodorsalis	Ramphocaenus melanurus	NA
Microbates cinereiventris cinereiventris	Microbates cinereiventris	NA
Microbates cinereiventris magdalenae	Microbates cinereiventris	NA
Microbates collaris	Microbates collaris	NA
Cercomacra sclateri	Cercomacra cinerascens	NA
Cercomacra tyrannina tyrannina	Cercomacroides tyrannina	NA
Cercomacra nigricans	Cercomacra nigricans	NA
Cercomacra berlepschi	Sipia berlepschi	NA
Pyriglena picea	Pyriglena leuconota	NA
Anoplops bicolor aequatorialis	Gymnopithys bicolor	NA
Anoplops bicolor daguae	Gymnopithys bicolor	NA
Anoplops bicolor bicolor	Gymnopithys bicolor	NA
Myrmeciza melanoceps	Akletos melanoceps	NA
Myrmeciza maculifer maculifer	Poliocrania exsul	NA
Myrmeciza maculifer cassini	Poliocrania exsul	NA
Myrmeciza immaculatus immaculatus	Hafferia immaculata	NA
Myrmeciza immaculatus berlepschi	Hafferia zeledoni	NA
Myrmeciza longipes boucardi	Myrmeciza longipes	NA
Myrmeciza longipes panamensis	Myrmeciza longipes	NA
Myrmeciza laemosticta nigricauda	Sipia nigricauda	NA
Gymnocichla nudiceps sanctaemartae	Gymnocichla nudiceps	NA
Dichrozona cinctus	Dichrozona cincta	NA
Hypocnemis cantator peruviana	Hypocnemis peruviana	NA
Hypocnemis hypoxantha	Hypocnemis hypoxantha	NA
Myrmoborus leucophrys leucophrys	Myrmoborus leucophrys	NA
Myrmoborus myiotherinus elegans	Myrmoborus myotherinus	NA
Hylophylax lepidonata	Willisornis poecilinotus	NA
Hylophylax naevia theresae	Hylophylax naevius	NA
Hylophylax naevioides	Hylophylax naevioides	NA
Phenostictus macleannani macleannani	Phaenostictus mcleannani	NA
Rhopoterpe torquata torquata	Myrmornis torquata	NA
Formicarius colma nigrifrons	Formicarius colma	NA
Formicarius analis connectens	Formicarius analis	NA
Formicarius nigricapillus destructus	Formicarius nigricapillus	NA
Formicarius analis saturatus	Formicarius analis	NA
Formicarius rufipectus carrikeri	Formicarius rufipectus	NA
Chamaeza brevicauda columbiana	Chamaeza nobilis	NA
Chamaeza brevicauda (nobilis?)	Chamaeza nobilis	NA
Chamaeza turdina	Chamaeza turdina	NA
Chamaeza mollissima	Chamaeza mollissima	NA
Pittasoma rosenbergi	Pittasoma rufopileatum	NA
Pittasoma harterti	Pittasoma rufopileatum	NA
Grallaria squamigera	Grallaria squamigera	NA
Grallaria guatimalensis chocoensis	Grallaria guatimalensis	NA
Grallaria alleni	Grallaria alleni	NA
Grallaria ruficeps	Grallaria nuchalis	NA
Grallaria rufocinerea	Grallaria rufocinerea	NA
Grallaria monticola	Grallaria quitensis	NA
Grallaria milleri	Grallaria milleri	NA
Grallaria hypoleuca	Grallaria hypoleuca	NA
Grallaria ruficapilla ruficapilla	Grallaria ruficapilla	NA
Grallaria brevicauda minor	Myrmothera campanisona	NA
Grallaria modesta	Myrmothera campanisona	NA
Oropezus rufula rufula	Grallaria rufula	NA
Hylopezus dives barbacoae	Hylopezus dives	NA
Hylopezus dives fulviventris	Hylopezus dives	NA
Hylopezus perspicillata periopthalmica	Hylopezus perspicillatus	NA
Hylopezus perspicillata perspicillata	Hylopezus perspicillatus	NA
Grallaricula costaricensis	Grallaricula flavirostris	NA
Grallaricula nana	Grallaricula nana	NA
Grallaricula cucullata	Grallaricula cucullata	NA
Furnarius agnatus	Furnarius leucopus	NA
Upucerthia excelsior columbiana	Cinclodes excelsior	NA
Lochmias sororia	Lochmias nematura	NA
Schizoeaca fuliginosa	Asthenes fuliginosa	NA
Leptasthenura andicola	Leptasthenura andicola	NA
Synallaxis azarae elegantior	Synallaxis azarae	NA
Synallazis azarae media	Synallaxis azarae	NA
Synallaxis moesta moesta	Synallaxis moesta	NA
Synallaxis moesta obscura	Synallaxis moesta	NA
Synallaxis albescens albigularis	Synallaxis albescens	NA
Synallaxis subpudica	Synallaxis subpudica	NA
Synallaxis pudica pudica	Synallaxis brachyura	NA
Synallaxis pudica nigrifumosa	Synallaxis brachyura	NA
Synallaxis pudica caucae	Synallaxis brachyura	NA
Synallaxis gujanensis columbianus	Synallaxis gujanensis	NA
Synallaxis cinnamomea fuscifrons	Synallaxis cinnamomea	NA
Synallaxis unirufa	Synallaxis unirufa	NA
Synallaxis candaei candaei	Synallaxis candei	NA
Synallaxis gularis gularis	Hellmayrea gularis	NA
Synallaxis rutilans caquetensis	Synallaxis rutilans	NA
Siptornis antisiensis	Cranioleuca curtata	NA
Siptornis erythrops griseigularis	Cranioleuca erythrops	NA
Siptornis striaticollis	Siptornis striaticollis	NA
Siptornis flammulata multostriata	Asthenes flammulata	NA
Siptornis flammulata quindiana	Asthenes flammulata	NA
Pseudocolaptes boissonneauti boissonneauti	Pseudocolaptes boissonneautii	NA
Hyloctistes subulatus subulatus	Automolus subulatus	NA
Hyloctistes subulatus assimilis	Automolus subulatus	NA
Automolus holostictus	Thripadectes holostictus	NA
Automolus ignobilis	Thripadectes ignobilis	NA
Automolus melanorhynchus	Thripadectes melanorhynchus	NA
Automolus ochrolaemus turdinus	Automolus ochrolaemus	NA
Automolus dorsalis	Anabazenops dorsalis	NA
Automolus pallidigularis pallidigularis	Automolus ochrolaemus	NA
Automolus infuscatus infuscatus	Automolus infuscatus	NA
Automolus nigricauda saturatus	Clibanornis rubiginosus	NA
Automolus cinnamomeigula	Clibanornis rubiginosus	NA
Philydor rufipileatus consobrinus	Clibanornis rufipectus	NA
Philydor pyrrhodes	Philydor pyrrhodes	NA
Philydor ruficaudatus	Anabacerthia ruficaudata	NA
Philydor montanus striaticollis	Anabacerthia striaticollis	NA
Thripadectes flammulatus	Thripadectes flammulatus	NA
Thripadectes virgaticeps sclateri	Thripadectes virgaticeps	NA
Ancistrops strigilatus	Ancistrops strigilatus	NA
Xenicopsis subalaris subalaris	Syndactyla subalaris	NA
Xenicopsis subalaris mentalis	Syndactyla subalaris	NA
Xenops genibarbis littoralis	Xenops minutus	NA
Xenops rutilus heterurus	Xenops rutilans	NA
Sclerurus brunneus	Sclerurus caudacutus	NA
Sclerurus albigularis albigularis	Sclerurus albigularis	NA
Sclerurus mexicanus obscurior	Sclerurus mexicanus	NA
Margarornis perlata	Margarornis squamiger	NA
Margarornis stellata	Margarornis stellatus	NA
Premnornis guttata	Premnornis guttuliger	NA
Premnoplex brunnescens brunnescens	Premnoplex brunnescens	NA
Glyphorhynchus cuneatus	Glyphorynchus spirurus	NA
Glyphorhynchus cuneatus castelnaudi	Glyphorynchus spirurus	NA
Glyphorhynchus cuneatus pectoralis	Glyphorynchus spirurus	NA
Dendrocincla tyrannina tyrannina	Dendrocincla tyrannina	NA
Dendrocincla lafresnayei lafresnayei	Dendrocincla fuliginosa	NA
Dendrocincla lafresnayei phaeochroa	Dendrocincla fuliginosa	NA
Xiphorhynchus guttata guttatoides	Xiphorhynchus guttatus	NA
Xiphorhynchus aequatorialis aequatorialis	Xiphorhynchus erythropygius	NA
Xiphorhynchus triangularis	Xiphorhynchus triangularis	NA
Xiphorhynchus lachrymosus lachrymosus	Xiphorhynchus lachrymosus	NA
Xiphorhynchus lachrymosus alarum	Xiphorhynchus lachrymosus	NA
Xiphorhynchus nanus nanus	Xiphorhynchus susurrans	NA
Xiphorhynchus insignis	Xiphorhynchus elegans	NA
Dendroplex picus picus	Dendroplex picus	NA
Dendroplex picus picirostris	Dendroplex picus	NA
Xiphocolaptes promeropirhynchus	Xiphocolaptes promeropirhynchus	NA
Picolaptes lacrymiger lacrymiger	Lepidocolaptes lacrymiger	NA
Picolaptes warscewiczi	Lepidocolaptes lacrymiger	NA
Picolaptes albolineatus	Lepidocolaptes souleyetii	NA
Campylorhamphus trochilirostris procurvoides	Campylorhamphus trochilirostris	NA
Campylorhamphus trochilirostris venezuelensis	Campylorhamphus trochilirostris	NA
Campylorhamphus thoracicus	Campylorhamphus trochilirostris	NA
Campylorhamphus pusillus	Campylorhamphus pusillus	NA
Campylorhamphus pucherani	Drymotoxeres pucheranii	NA
Dendrocolaptes validus validus	Dendrocolaptes picumnus	NA
Dendrocolaptes sancti-thomae sancti-thomae	Dendrocolaptes sanctithomae	NA
Dexdrocolaptes sancti-thomae radiolatus	Dendrocolaptes certhia	NA
Orodynastes striaticollis striaticollis	Myiotheretes striaticollis	NA
Ochthodiaeta fumigata	Myiotheretes fumigatus	NA
Ochthoeca oenanthoides fumicolor	Ochthoeca oenanthoides	NA
Ochthoeca oenanthoides brunneifrons	Ochthoeca oenanthoides	NA
Ochthoeca albidiedema	Ochthoeca frontalis	NA
Ochthoeca frontalis	Ochthoeca frontalis	NA
Ochthoeca lessoni	Ochthoeca rufipectoralis	NA
Ochthoeca cinnamomeiventris	Ochthoeca cinnamomeiventris	NA
Ochthoeca gratiosa gratiosa	Ochthoeca diadema	NA
Mecocerculus leucophrys setophagoides	Mecocerculus leucophrys	NA
Mecocerculus stictopterus	Mecocerculus stictopterus	NA
Mecocerculus poecilocercus	Mecocerculus poecilocercus	NA
Ochthornis littoralis	Ochthornis littoralis	NA
Fluvicola pica	Fluvicola pica	NA
Arundinicola leucocephala	Arundinicola leucocephala	NA
Copurus colonus fuscicapillus	Colonia colonus	NA
Copurus leuconotus	Colonia colonus	NA
Machetornis rixosus flavigularis	Machetornis rixosa	NA
Muscisaxicola alpina columbiana	Muscisaxicola alpinus	NA
Platytriccus flavigularis	Platyrinchus flavigularis	NA
Platytriccus albogularis	Platyrinchus mystaceus	NA
Placostomus coronatus	Platyrinchus coronatus	NA
Craspedoprion aequinoctialis	Rhynchocyclus olivaceus	NA
Craspedoprion pacificus	Rhynchocyclus pacificus	NA
Craspedoprion fulvipectus	Rhynchocyclus fulvipectus	NA
Rhynchocyclus sulphurescens asemus	Tolmomyias sulphurescens	NA
Rhynchocyclus sulphurescens assimilis	Tolmomyias assimilis	NA
Rhynchocyclus sulphurescens exortivus	Tolmomyias sulphurescens	NA
Rhynchocyclus marginatus marginatus	Tolmomyias sulphurescens	NA
Rhynchocyclus viridiceps	Tolmomyias flaviventris	NA
Rhynchocyclus flaviventris aurulentus	Tolmomyias flaviventris	NA
Rhynchocyclus klagesi	Tolmomyias poliocephalus	NA
Todirostrum cinereum cinereum	Todirostrum cinereum	NA
Todirostrum sclateri	Todirostrum cinereum	NA
Todirostrum nigriceps	Todirostrum nigriceps	NA
Todirostrum schistaceiceps superciliare	Poecilotriccus sylvia	NA
Todirostrum latirostre	Poecilotriccus latirostris	NA
Pescilotriccus ruficeps ruficeps	Poecilotriccus ruficeps	NA
Pcecilotriccus ruficeps rufigene	Poecilotriccus ruficeps	NA
Euscarthmus striaticollis zosterops	Hemitriccus zosterops	NA
Euscarthmus granadensis	Hemitriccus granadensis	NA
Euscarthmus septentrionalis	Hemitriccus margaritaceiventer	NA
Pseudotriccus pelzelni pelzelni	Pseudotriccus pelzelni	NA
Pseudotriccus annectens	Pseudotriccus pelzelni	NA
Caenotriccus ruficeps ruficeps	Pseudotriccus ruficeps	NA
Lophotriccus spicifer	Lophotriccus vitiosus	NA
Lophotriccus squamaecristatus squamaecristatus	Lophotriccus pileatus	NA
Lophotriccus squamaecristatus minor	Lophotriccus pileatus	NA
Orchilus atricapillus	Myiornis atricapillus	NA
Atalotriccus pilaris pilaris	Atalotriccus pilaris	NA
Hapalocercus meloryphus	Euscarthmus meloryphus	NA
Hapalocercus acutipennis	Pseudocolopteryx acutipennis	NA
Habrura pectoralis bogotensis	Polystictus pectoralis	NA
Pogonotriccus poecilotis	Phylloscartes poecilotis	NA
Pogonotriccus opthalmicus	Phylloscartes ophthalmicus	NA
Oreotriccus plumbeiceps	Poecilotriccus plumbeiceps	NA
Serpophaga cinerea cana	Serpophaga cinerea	NA
Inezia caudata intermedia	Inezia caudata	NA
Anaeretes parulus aequatorialis	Anairetes parulus	NA
Anaeretes agilis	Uromyias agilis	NA
Mionectes striaticollis poliocephalus	Mionectes striaticollis	NA
Mionectes olivaceus hederaceus	Mionectes olivaceus	NA
Mionectes olivaceus pallidus	Mionectes olivaceus	NA
Pipromorpha oleaginea oleaginea	Mionectes oleagineus	NA
Pipromorpha oleaginea parca	Mionectes oleagineus	NA
Leptopogon superciliaris poliocephalus	Leptopogon superciliaris	NA
Leptopogon amaurocephalus	Leptopogon amaurocephalus	NA
Leptopogon erythrops	Leptopogon rufipectus	NA
Capsiempis flaveola leucophrys	Capsiempis flaveola	NA
Phyllomyias griseiceps griseiceps	Phyllomyias griseiceps	NA
Phyllomyias griseiceps caucae	Phyllomyias griseiceps	NA
Acrochordopus zeledoni	Phyllomyias burmeisteri	NA
Phaeomyias murina incomta	Phaeomyias murina	NA
Camptostoma pusillum pusillum	Camptostoma obsoletum	NA
Camptostoma pusillum napaeuum	Camptostoma obsoletum	NA
Camptostoma caucae	Camptostoma obsoletum	NA
Microtriccus brunneicapillus brunneicapililus	Ornithion brunneicapillus	NA
Tyrannulus elatus reguloides	Tyrannulus elatus	NA
Mecocerculus uropygialis	Phyllomyias uropygialis	NA
Tyranniscus nigricapillus nigricapillus	Phyllomyias nigrocapillus	NA
Tyranniscus cinereiceps	Phyllomyias cinereiceps	NA
Tyranniscus chrysops chrysops	Zimmerius chrysops	NA
Elaenia flavogaster flavogaster	Elaenia flavogaster	NA
Elaenia gigas	Elaenia gigas	NA
Elaenia chiriquensis chiriquensis	Elaenia chiriquensis	NA
Elaenia pudica brachyptera	Elaenia frantzii	NA
Elaenia parvirostris	Elaenia parvirostris	NA
Elaenia pudica pudica	Elaenia frantzii	NA
Myiopagis viridicata accola	Myiopagis viridicata	NA
Myiopagis viridicata pallens	Myiopagis viridicata	NA
Legatus albicollis	Legatus leucophaius	NA
Sublegatus glaber	Sublegatus arenarum	NA
Myiozetetes cayanensis cayanensis	Myiozetetes cayanensis	NA
Myiozetetes similis columbianus	Myiozetetes similis	NA
Myiozetetes granadensis	Myiozetetes granadensis	NA
Myiozetetes similis connivens	Myiozetetes similis	NA
Conopias cinchoneti	Conopias cinchoneti	NA
Pitangus sulphuratus rufipennis	Pitangus sulphuratus	NA
Pitangus sulphuratus	Pitangus sulphuratus	NA
Pitangus sulphuratus caucensis	Pitangus sulphuratus	NA
Pitangus lictor	Pitangus lictor	NA
Sirystes albocinereus	Sirystes albocinereus	NA
Myiodynastes maculatus nobilis	Myiodynastes maculatus	NA
Myiodynastes luteiventris	Myiodynastes luteiventris	NA
Myiodynastes chrysocephalus minor	Myiodynastes chrysocephalus	NA
Megarhynchus pitangua	Megarynchus pitangua	NA
Onychorhynchus coronatus castelnaudi	Onychorhynchus coronatus	NA
Hirundinea sclateri	Hirundinea ferruginea	NA
Cnipodectes minor	Cnipodectes subbrunneus	NA
Myiobius barbatus barbatus	Myiobius barbatus	NA
Myiobius barbatus atricaudus	Myiobius barbatus	NA
Myiobius villosus	Myiobius villosus	NA
Myiobius sulphureipygius aureatus	Myiobius sulphureipygius	NA
Myiobius cinnamomeus pyrrhopterus	Pyrrhomyias cinnamomeus	NA
Myiobius flavicans	Myiophobus flavicans	NA
Myiobius litae	Myiophobus phoenicomitra	NA
Myiobius pulcher pulcher	Nephelomyias pulcher	NA
Myiobius pulcher bellus	Nephelomyias pulcher	NA
Myiobius fasciatus fasciatus	Myiophobus fasciatus	NA
Terenotriccus erythrurus fulvigularis	Terenotriccus erythrurus	NA
Myiotriccus ornatus ornatus	Myiotriccus ornatus	NA
Myiotriccus ornatus stellatus	Myiotriccus ornatus	NA
Myiotriccus phoenicurus	Myiotriccus ornatus	NA
Pyrocephalus pyrocephalus rubinus	Pyrocephalus rubinus	NA
Pyrocephalus rubinus heterurus	Pyrocephalus rubinus	NA
Empidochanes cabanisi	Cnemotriccus fuscatus	NA
Empidochanes poecilurus	Knipolegus poecilurus	NA
Mitrephanes berlepschi eminulus	Mitrephanes phaeocercus	NA
Sayornis nigricans cineracea	Sayornis nigricans	NA
Empidonax virescens	Empidonax virescens	NA
Empidonax trailli alnorum	Empidonax alnorum	NA
Myiochanes ardosiacus ardosiacus	Contopus fumigatus	NA
Myiochanes virens	Contopus virens	NA
Myiochanes richardsoni	Contopus sordidulus	NA
Myiochanes brachytarsus	Contopus cinereus	NA
Myiarchus crinitus (Linn)	Myiarchus crinitus	NA
Myiarchus tyrannulus tyrannulus	Myiarchus tyrannulus	NA
Myiarchus fortirostris	Myiarchus swainsoni	NA
Myiarchus (ferox?) venezuelensis	Myiarchus venezuelensis	NA
Myiarchus (ferox?) panamensis	Myiarchus panamensis	NA
Myiarchus cephalotes	Myiarchus cephalotes	NA
Myiarchus apicalis	Myiarchus apicalis	NA
Myiarchus tuberculifer nigriceps	Myiarchus tuberculifer	NA
Myiarchus tuberculifer tuberculifer	Myiarchus tuberculifer	NA
Tyrannus tyrannus	Tyrannus tyrannus	NA
Tyrannus niveigularis	Tyrannus niveigularis	NA
Tyrannus dominicensis	Tyrannus dominicensis	NA
Tyrannus melancholicus satrapa	Tyrannus melancholicus	NA
Muscivora tyrannus	Tyrannus forficatus	NA
Pipra erythrocephala erythrocephala	Ceratopipra erythrocephala	NA
Pipra erythrocephala berlepschi	Ceratopipra erythrocephala	NA
Pipra mentalis minor	Ceratopipra mentalis	NA
Pipra leucocilla minimus	Dixiphia pipra	NA
Pipra leucocilla coracina	Dixiphia pipra	NA
Pipra isadorei isadorei	Lepidothrix isidorei	NA
Pipra velutina	Lepidothrix coronata	NA
Pipra coronata	Lepidothrix coronata	NA
Cirrhipipra filicauda	Pipra filicauda	NA
Machaeropterus striolatus	Machaeropterus striolatus	NA
Allocopterus deliciosus	Machaeropterus deliciosus	NA
Chloropipo flavicapilla	Chloropipo flavicapilla	NA
Chloropipo holochlora holochlora	Cryptopipo holochlora	NA
Chloropipo holochlora litae	Cryptopipo holochlora	NA
Piprites tschudi	Piprites chloris	NA
Masius chrysopterus	Masius chrysopterus	NA
Masius corunulatus	Masius chrysopterus	NA
Chiroxiphia pareola napensis	Chiroxiphia pareola	NA
Corapipo leucorrhoa	Corapipo leucorrhoa	NA
Corapipo altera altera	Corapipo altera	NA
Manacus manacus abditivus	Manacus manacus	NA
Manacus manacus interior	Manacus manacus	NA
Manacus manacus bangsi	Manacus manacus	NA
Manacus manacus flaveolus	Manacus manacus	NA
Manacus vitellinus vitellinus	Manacus vitellinus	NA
Manacus vitellinus milleri	Manacus vitellinus	NA
Scotothorus turdinus rosenbergi	Schiffornis veraepacis	NA
Scotothorus turdinus stenorhynchus	Schiffornis stenorhyncha	NA
Sapayoa aenigma	Sapayoa aenigma	NA
Tityra cayana	Tityra cayana	NA
Tityra semifasciata semifasciata	Tityra semifasciata	NA
Tityra semifasciata columbiana	Tityra semifasciata	NA
Tityra semifasciata esmeraldae	Tityra semifasciata	NA
Tityra buckleyi	Tityra inquisitor	NA
Platypsaris homochrous homochrous	Pachyramphus homochrous	NA
Platypsaris minor	Pachyramphus minor	NA
Pachyrhamphus versicolor	Pachyramphus versicolor	NA
Pachyrhamphus rufus	Pachyramphus rufus	NA
Pachyrhamphus cinnamomeus	Pachyramphus cinnamomeus	NA
Pachyrhamphus magdalenae	Pachyramphus cinnamomeus	NA
Pachyrhamphus sp	Pachyrhamphus sp	NA
Pachyrhamphus castaneus saturatus	Pachyramphus castaneus	NA
Pachyrhamphus polychropterus niger	Pachyramphus polychopterus	NA
Pachyrhamphus atricapillus	Pachyramphus ?marginatus?	NA
Pachyrhamphus dorsalis	Pachyramphus polychopterus	NA
Lathria fuscocinerea fuscocinerea	Lipaugus fuscocinereus	NA
Lathria cinerea	Lipaugus vociferans	NA
Lathria unirufa castaneotincta	Lipaugus unirufus	NA
Lathria cryptolopha	Snowornis cryptolophus	NA
Lipaugus simplex	Rhytipterna simplex	NA
Lipaugus holerythrus holerythrus	Rhytipterna holerythra	NA
Lipaugus holerythrus rosenbergi	Rhytipterna holerythra	NA
Attila brasiliensis parambae	Attila spadiceus	NA
Attila citreopygus citreopygus	Attila spadiceus	NA
Rupicola peruviana aurea	Rupicola peruvianus	NA
Rupicola peruviana sanguinolenta	Rupicola peruvianus	NA
Euchlornis arcuata	Pipreola arcuata	NA
Stictornis cinctus	Ampelioides tschudii	NA
Euchlornis riefferi riefferi	Pipreola riefferii	NA
Euchlornis riefferi occidentalis	Pipreola riefferii	NA
Euchlornis lubomirski	Pipreola lubomirskii	NA
Euchlornis jucunda	Pipreola jucunda	NA
Cotinga nattereri	Cotinga nattererii	NA
Carpodectes hopkei	Carpodectes hopkei	NA
Heliochera rubrocristata	Ampelion rubrocristatus	NA
Hoeliochera rufaxilla	Ampelion rufaxilla	NA
Querula purpurata	Querula purpurata	NA
Pyroderus scutatus granadensis	Pyroderus scutatus	NA
Pyroderus scutatus occidentalis	Pyroderus scutatus	NA
Cephalopterus ornatus	Cephalopterus ornatus	NA
Cephalopterus penduliger	Cephalopterus penduliger	NA
Riparia riparia	Riparia riparia	NA
Iridoprocne albiventris	Tachycineta albiventer	NA
Hirundo erythrogaster	Hirundo rustica	NA
Progne chalybea chalybea	Progne chalybea	NA
Phaeoprogne tapera immaculata	Progne tapera	NA
Atticora fasciata	Atticora fasciata	NA
Orochelidon murina	Orochelidon murina	NA
Neochelidon tibialis	Atticora tibialis	NA
Pygochelidon cyanoleuca	Pygochelidon cyanoleuca	NA
Stelgidopteryx ruficollis ruficollis	Stelgidopteryx ruficollis	NA
Stelgidopteryx ruficollis aequalis	Stelgidopteryx ruficollis	NA
Stelgidopteryx ruficollis uropygialis	Stelgidopteryx ruficollis	NA
Polioptila livida plumbeiceps	Polioptila plumbea	NA
Polioptila livida daguae	Polioptila plumbea	NA
Polioptila schistaceigula	Polioptila schistaceigula	NA
Cinnicerthia unirufa	Cinnycerthia unirufa	NA
Cinnicerthia unibrunnea	Cinnycerthia unirufa	NA
Cinnicerthia olivascens	Cinnycerthia olivascens	NA
Heleodytes minor bicolor	Campylorhynchus griseus	NA
Heleodytes albobrunneus harterti	Campylorhynchus albobrunneus	NA
Heleodytes turdinus hypostictus	Campylorhynchus turdinus	NA
Heleodytes zonatus brevirostris	Campylorhynchus zonatus	NA
Heleodytes nuchalis nuchalis	Campylorhynchus nuchalis	NA
Odontorchilus branicki	Odontorchilus branickii	NA
Thryophilus leucotis	Cantorchilus leucotis	NA
Thryophilus galbraithi galbraithi	Cantorchilus leucotis	NA
Thryophilus albipectus bogotensis	Cantorchilus leucotis	NA
Thryophilus rufalbus cumanensis	Thryophilus rufalbus	NA
Thryophilus leucopogon	Cantorchilus leucopogon	NA
Thryophilus nigricapillus schotti	Cantorchilus nigricapillus	NA
Thryophilus nigricapillus connectens	Cantorchilus nigricapillus	NA
Pheugopedius spadix	Pheugopedius spadix	NA
Pheugopedius fasciato-ventris fasciato-ventris	Pheugopedius fasciatoventris	NA
Pheugopedius mystacalis mystacalis	Pheugopedius mystacalis	NA
Pheugopedius mystacalis amaurogaster	Pheugopedius mystacalis	NA
Pheugopedius sclateri	Pheugopedius sclateri	NA
Pheugopedius hypospodius	Pheugopedius rutilus	NA
Cistothorus aequatorialis	Cistothorus platensis	NA
Cistothorus apolinari	Cistothorus apolinari	NA
Troglodytes musculus striatulus	Troglodytes aedon	NA
Troglodytes musculus columbae	Troglodytes aedon	NA
Troglodytes musculus neglectus	Troglodytes aedon	NA
Troglodytes solstitialis pallidipectus	Troglodytes solstitialis	NA
Henicorhina leucosticta	Henicorhina leucosticta	NA
Henicorhina prostheleuca eucharis	Henicorhina leucosticta	NA
Henicorhina prostheleuca albilateralis	Henicorhina leucosticta	NA
Henicorhina inornata	Henicorhina leucosticta	NA
Henicorhina leucophrys guttata	Henicorhina leucophrys	NA
Henicorhina leucophrys brunneiceps	Henicorhina leucophrys	NA
Leucolepis salvini	Cyphorhinus arada	NA
Leucolepis phaeocephalus phaeocephalus	Cyphorhinus phaeocephalus	NA
Leucolepis dichrous	Cyphorhinus thoracicus	NA
Microcerculus marginatus marginatus	Microcerculus marginatus	NA
Microcerculus marginatus occidentalis	Microcerculus marginatus	NA
Microcerculus squamulatus antioquensis	Microcerculus marginatus	NA
Cinclus leuconotus	Cinclus leucocephalus	NA
Mimus gilvus tolimensis	Mimus gilvus	NA
Mimus gilvus columbianus	Mimus gilvus	NA
Donacobius atricapillus albovittatus	Donacobius atricapilla	NA
Rhodinocichla rosea rosea	Rhodinocichla rosea	NA
Myiadestes ralloides venezuelensis	Myadestes ralloides	NA
Planesticus serranus	Turdus serranus	NA
Planesticus fuscobrunneus	Turdus serranus	NA
Planesticus leucops	Turdus leucops	NA
Planesticus caucae	Turdus olivater	NA
Planesticus phaeopygus	Turdus albicollis	NA
Planesticus tristis daguae	Turdus assimilis	NA
Planesticus gymnopthalmus	Turdus nudigenis	NA
Planesticus ignobilis ignobilis	Turdus ignobilis	NA
Planesticus ignobilis goodfellowi	Turdus ignobilis	NA
Planesticus ignobilis debilis	Turdus ignobilis	NA
Planesticus obsoletus colombianus	Turdus obsoletus	NA
Planesticus albiventer ephippialis	Turdus leucomelas	NA
Semimerula gigas gigas	Turdus fuscater	NA
Semimerula gigas gigantodes	Turdus fuscater	NA
Hylocichla aliciae aliciae	Catharus minimus	NA
Hylocichle ustulata swainsoni	Catharus ustulatus	NA
Catharus birchalli	Catharus aurantiirostris	NA
Catharus phaeopleurus	Catharus aurantiirostris	NA
Catharus dryas	Catharus dryas	NA
Vireosylva olivacea	Vireo olivaceus	NA
Vireosylva flavoviridis flavoviridis	Vireo flavoviridis	NA
Vireosylva chivi caucae	Vireo chivi	NA
Vireosylva josephae josephae	Vireo leucophrys	NA
Lanivireo flavifrons	Vireo flavifrons	NA
Pachysylvia semibrunnea	Pachysylvia semibrunnea	NA
Pachysylvia flavipes flavipes	Hylophilus flavipes	NA
Pachysylvia minor	Pachysylvia decurtata	NA
Cyclarhis flavipectus canticus	Cyclarhis gujanensis	NA
Cyclarhis flavipectus parvus	Cyclarhis gujanensis	NA
Cyclarhis nigrirostris	Cyclarhis nigrirostris	NA
Mniotilta varia	Mniotilta varia	NA
Protonotaria citrea	Protonotaria citrea	NA
Vermivora chrysoptera	Vermivora chrysoptera	NA
Vermivora peregrina	Leiothlypis peregrina	NA
Compsothlypis pitiayumi elegans	Setophaga pitiayumi	NA
Compsothlypis pitiayumi pacifica	Setophaga pitiayumi	NA
Dendroica aestiva aestiva	Setophaga petechia	NA
Dendroica petechia aequatorialis	Setophaga petechia	NA
Dendroica caerulea	Setophaga cerulea	NA
Dendroica fusca	Setophaga fusca	NA
Dendroica castanea	Setophaga castanea	NA
Dendroica striata	Setophaga striata	NA
Oporornis philadelphia	Geothlypis philadelphia	NA
Seiurus noveboracensis noveboracensis	Parkesia noveboracensis	NA
Seiurus noveboracensis notabilis	Parkesia noveboracensis	NA
Geothlypis semiflava	Geothlypis semiflava	NA
Geothlypis aequinoctialis	Geothlypis aequinoctialis	NA
Wilsonia canadensis	Cardellina canadensis	NA
Setophaga ruticilla	Setophaga ruticilla	NA
Myioborus verticalis verticalis	Myioborus miniatus	NA
Myioborus ornatus	Myioborus ornatus	NA
Myioborus chrysops	Myioborus ornatus	NA
Myiothlypis nigrocristatus	Myiothlypis nigrocristata	NA
Basileuterus luteoviridis	Myiothlypis luteoviridis	NA
Basileuterus richardsoni	Myiothlypis luteoviridis	NA
Basileuterus cinereicollis	Myiothlypis cinereicollis	NA
Basileuterus cabanisi	Basileuterus culicivorus	NA
Basileuterus tristriatus tristriatus	Basileuterus tristriatus	NA
Basileuterus coronatus	Myiothlypis coronata	NA
Basileuterus bivittatus chlorophrys	Myiothlypis bivittata	NA
Basileuterus auricapillus olivascens	Basileuterus culicivorus	NA
Basileuterus rufifrons mesochrysus	Basileuterus rufifrons	NA
Basileuterus fulvicauda semicervinus	Myiothlypis fulvicauda	NA
Basileuterus fulvicauda fulvicauda	Myiothlypis fulvicauda	NA
Anthus bogotensis	Anthus bogotensis	NA
Otocoris alpestris peregrina	Eremophila alpestris	NA
Catamblyrhynchus diadema	Catamblyrhynchus diadema	NA
Pheucticus uropygialis uropygialis	Pheucticus aureoventris	NA
Zamelodia ludoviciana	Pheucticus ludovicianus	NA
Cyanocompsa concreta cyanescens	Cyanoloxia cyanoides	NA
Cyanocompsa cyanea caucae	Cyanoloxia brissonii	NA
Oryzoborus angolensis	Sporophila angolensis	NA
Oryzoborus crassirostris crassirostris	Sporophila crassirostris	NA
Oryzoborus funereus	Sporophila funerea	NA
Sporophila grisea grisea	Sporophila intermedia	NA
Sporophila castaneiventris	Sporophila castaneiventris	NA
Sporophila minuta minuta	Sporophila minuta	NA
Sporophila aurita aurita	Sporophila corvina	NA
Sporophila aurita ophthalmica	Sporophila corvina	NA
Sporophila aurita murallae	Sporophila murallae	NA
Sporophila gutturalis	Sporophila nigricollis	NA
Sporophila luctuosa	Sporophila luctuosa	NA
Catamenia inornata minor	Catamenia inornata	NA
Catamenia homochroa	Catamenia homochroa	NA
Catamenia analoides schistaceifrons	Catamenia analis	NA
Tiaris olivacea pusilla	Tiaris olivaceus	NA
Tiaris bicolor omissa	Melanospiza bicolor	NA
Volatinia jacarini splendens	Volatinia jacarina	NA
Pitylus grossus	Saltator grossus	NA
Saltator maximus	Saltator maximus	NA
Saltator atripennis atripennis	Saltator atripennis	NA
Saltator atripennis caniceps	Saltator atripennis	NA
Saltator olivascens	Saltator coerulescens	NA
Saltator caerulescens azarae	Saltator coerulescens	NA
Saltator striatipectus striatipectus	Saltator striatipectus	NA
Spinus spinescens spinescens	Spinus spinescens	NA
Spinus nigricauda	Spinus spinescens	NA
Spinus xanthogaster	Spinus xanthogastrus	NA
Astragalinus psaltria columbianus	Spinus psaltria	NA
Sicalis flaveola	Sicalis flaveola	NA
Sicalis arvensis minor	Sicalis luteola	NA
Spiza americana	Spiza americana	NA
Ammodramus savannarum caucae	Ammodramus savannarum	NA
Myospiza manimbe columbiana	Ammodramus humeralis	NA
Myospiza aurifrons	Ammodramus aurifrons	NA
Myospiza cherriei	Ammodramus aurifrons	NA
Brachyspiza capensis peruviana	Zonotrichia capensis	NA
Arremonops conirostris conirostris	Arremonops conirostris	NA
Arremonops conirostris inexpectata	Arremonops conirostris	NA
Arremonops conirostris chrysoma	Arremonops conirostris	NA
Emberizoides sphenurus	Emberizoides herbicola	NA
Pseudochloris citrina antioquiae	Sicalis citrina	NA
Phrygilus unicolor grandis	Geospizopsis unicolor	NA
Phrygilus unicolor geospizopsis	Geospizopsis unicolor	NA
Spodiornis jardini	Spodiornis rusticus	NA
Paroaria gularis	Paroaria gularis	NA
Arremon aurantiirostris erythrorhynchus	Arremon aurantiirostris	NA
Arremon aurantiirostris occidentalis	Arremon aurantiirostris	NA
Arremon axillaris	Arremon taciturnus	NA
Lysurus castaneiceps	Arremon castaneiceps	NA
Atlapetes flaviceps	Atlapetes flaviceps	NA
Atlapetes fusco-olivaceus	Atlapetes fuscoolivaceus	NA
Atlapetes gutturalis gutturalis	Atlapetes albinucha	NA
Atlapetes latinuchus latinuchus	Atlapetes latinuchus	NA
Atlapetes latinuchus elaeoprorus	Atlapetes latinuchus	NA
Atlapetes albifrenatus	Atlapetes albofrenatus	NA
Atlapetes schistaceus	Atlapetes schistaceus	NA
Atlapetes pallidinuchus pallidinuchus	Atlapetes pallidinucha	NA
Atlapetes pallidinuchus papallactae	Atlapetes pallidinucha	NA
Atlapetes crassus	Atlapetes tricolor	NA
Atlapetes semirufus	Atlapetes semirufus	NA
Buarremon brunneinuchus	Arremon brunneinucha	NA
Buarremon assimilis	Arremon assimilis	NA
Buarremon atricapillus	Arremon atricapillus	NA
Coereba luteola luteola	Coereba flaveola	NA
Coereba mexicana columbiana	Coereba flaveola	NA
Coereba mexicana caucae	Coereba flaveola	NA
Diglossa sittoides similis	Diglossa sittoides	NA
Diglossa gloriosissima	Diglossa gloriosissima	NA
Diglossa brunneiventris	Diglossa brunneiventris	NA
Diglossa lafresnayei	Diglossa lafresnayii	NA
Diglossa humeralis	Diglossa humeralis	NA
Diglossa aterrima	Diglossa humeralis	NA
Diglossa albilateralis	Diglossa albilatera	NA
Diglossa personata	Diglossa cyanea	NA
Diglossa cryptorhis	Diglossa indigotica	NA
Diglossopis caerulescens caerulescens	Diglossa caerulescens	NA
Conirostrum sitticolor	Conirostrum sitticolor	NA
Conirostrum rufum	Conirostrum rufum	NA
Conirostrum fraseri	Conirostrum cinereum	NA
Conirostrum albifrons	Conirostrum albifrons	NA
Conirostrum atrocyaneum	Conirostrum albifrons	NA
Dacnis cayana cayana	Dacnis cayana	NA
Dacnis cayana coerebicolor	Dacnis cayana	NA
Dacnis angelica	Dacnis lineata	NA
Dacnis egregia egregia	Dacnis lineata	NA
Dacnis venusta fuliginata	Dacnis venusta	NA
Dacnis leucogenys	Conirostrum leucogenys	NA
Cyanerpes cyaneus pacificus	Cyanerpes cyaneus	NA
Cyanerpes caerulea microrhyncha	Cyanerpes caeruleus	NA
Chlorophanes spiza exsul	Chlorophanes spiza	NA
Chlorophanes spiza caerulescens	Chlorophanes spiza	NA
Tersina viridis occidentalis	Tersina viridis	NA
Chlorophonia pretrei	Chlorophonia pyrrhophrys	NA
Tanagra cyanocephala cyanocephala	Euphonia cyanocephala	NA
Tanagra aurea pileata	Nemosia pileata	NA
Tanagra xanthogastra chocoensis	Euphonia xanthogaster	NA
Tanmagra xanthogastra brevirostris	Euphonia xanthogaster	NA
Tanagra concinna	Euphonia concinna	NA
Tanagra saturata	Euphonia saturata	NA
Tanagra olivacea humilis	Euphonia minuta	NA
Tanagra fulvicrissa purpurascens	Euphonia fulvicrissa	NA
Tanagra fulvicrissa omissa	Euphonia fulvicrissa	NA
Tanagra crassirostris crassirostris	Euphonia laniirostris	NA
Tanagra melanura	Euphonia laniirostris	NA
Tanagra chrysopasta	Euphonia chrysopasta	NA
Chlorochrysa calliparaea bourcieri	Chlorochrysa calliparaea	NA
Chlorochrysa phoenicotis	Chlorochrysa phoenicotis	NA
Chlorochrysa nitidissima	Chlorochrysa nitidissima	NA
Pipridea melanota venezuelensis	Pipraeidea melanonota	NA
Procnopis vassori	Tangara vassorii	NA
Tangara chilensis	Tangara chilensis	NA
Tangara schrankii	Tangara schrankii	NA
Tangara johannae	Tangara johannae	NA
Tangara florida auriceps	Tangara florida	NA
Tangara guttata bogotensis	Ixothraupis guttata	NA
Tangara guttata tolimae	Ixothraupis guttata	NA
Tangara xanthogastra	Ixothraupis xanthogastra	NA
Tangara rufigula	Ixothraupis rufigula	NA
Tangara aurulenta aurulenta	Tangara arthus	NA
Tangara aurulenta occidentalis	Tangara arthus	NA
Tangara icterocephala	Tangara icterocephala	NA
Tangara vitriolina	Stilpnia vitriolina	NA
Tangara lavinia lavinia	Tangara lavinia	NA
Tangara gyroloides gyroloides	Tangara gyrola	NA
Tangara gyroloides catharinae	Tangara gyrola	NA
Tangara gyroloides bangsi	Tangara gyrola	NA
Tangara palmeri	Poecilostreptus palmeri	NA
Tangara mexicana boliviana	Tangara mexicana	NA
Tangara inornata inornata	Tangara inornata	NA
Tangara nigroviridis nigroviridis	Tangara nigroviridis	NA
Tangara larvata fanny	Stilpnia larvata	NA
Tangara cyaneicollis caeruleocephala	Stilpnia cyanicollis	NA
Tangara cyaneicollis granadensis	Stilpnia cyanicollis	NA
Tangara ruficervix ruficervix	Chalcothraupis ruficervix	NA
Tangara labradorides	Tangara labradorides	NA
Tangara melanotis	Tangara cyanotis	NA
Tangara parzudaki	Tangara parzudakii	NA
Tangara venusta	Tangara xanthocephala	NA
Tangara atricapilla	Stilpnia heinei	NA
Iridosornis dubusia dubusia	Iridosornis rufivertex	NA
Iridosornis dubusia ignicapillus	Iridosornis rufivertex	NA
Iridosornis dubusia caeruleoventris	Iridosornis rufivertex	NA
Iridosornis porphyrocephala	Iridosornis porphyrocephalus	NA
Poecilothraupis lunulata lunulata	Anisognathus igniventris	NA
Poecilothraupis palpebrosa palpebrosa	Anisognathus lacrymosus	NA
Pocilothraupis palpebrosa olivaceiceps	Anisognathus lacrymosus	NA
Buthraupis cucullata cucullata	Buthraupis montana	NA
Buthraupis cucullata gigas	Buthraupis montana	NA
Buthraupis eximia chloronota	Cnemathraupis eximia	NA
Buthraupis eximia eximia	Cnemathraupis eximia	NA
Buthraupis edwardsi	Bangsia edwardsi	NA
Buthraupis rothschildi	Bangsia rothschildi	NA
Buthraupis melanochlamys	Bangsia melanochlamys	NA
Buthraupis aureocincta	Bangsia aureocincta	NA
Compsocoma somptuosa victorini	Anisognathus somptuosus	NA
Compsocoma somptuosa antioquiae	Anisognathus somptuosus	NA
Compsocoma somptuosa cyanoptera	Anisognathus somptuosus	NA
Compsocoma notabilis	Anisognathus notabilis	NA
Dubusia taeniata	Dubusia taeniata	NA
Thraupis episcopus leucoptera	Thraupis episcopus	NA
Thraupis coelestis coelestis	Thraupis episcopus	NA
Thraupis cana cana	Thraupis episcopus	NA
Thraupis glaucocolpa	Thraupis glaucocolpa	NA
Thraupis palmarum melanoptera	Thraupis palmarum	NA
Sporathraupis cyanocephala auricrissa	Thraupis cyanocephala	NA
Ramphocelus nigrogularis	Ramphocelus nigrogularis	NA
Ramphocelus dimidiatus dimidiatus	Ramphocelus dimidiatus	NA
Ramphocelus carbo carbo	Ramphocelus carbo	NA
Ramphocelus carbo unicolor	Ramphocelus carbo	NA
Ramphocelus flammigerus	Ramphocelus flammigerus	NA
Ramphocelus chrysonotus	Ramphocelus flammigerus	NA
Ramphocelus icteronotus	Ramphocelus flammigerus	NA
Calochaetes coccineus	Calochaetes coccineus	NA
Piranga rubra rubra	Piranga rubra	NA
Piranga testacea testacea	Piranga flava	NA
Piranga leucoptera ardens	Piranga leucoptera	NA
Piranga rubriceps	Piranga rubriceps	NA
Chlorothraupis olivacea	Chlorothraupis olivacea	NA
Chlorothraupis stolzmanni	Chlorothraupis stolzmanni	NA
Phoenicothraupis cristata	Habia cristata	NA
Phoenicothraupis gutturalis	Habia gutturalis	NA
Heterospingus xanthopygius	Heterospingus xanthopygius	NA
Tachyphonus rufus	Tachyphonus rufus	NA
Tachyphonus luctuosus	Tachyphonus luctuosus	NA
Tachyphonus surinamus surinamus	Tachyphonus surinamus	NA
Tachyphonus delattrii	Tachyphonus delatrii	NA
Creurgops verticalis	Creurgops verticalis	NA
Eucometis cristata cristata	Eucometis penicillata	NA
Mitrospingus cassini	Mitrospingus cassinii	NA
Erythrothlypis salmoni	Chrysothlypis salmoni	NA
Hemithraupis peruana	Hemithraupis flavicollis	NA
Hemithraupis guira guirina	Hemithraupis guira	NA
Sericossypha albocristata	Sericossypha albocristata	NA
Chlorospingus albitempora nigriceps	Chlorospingus flavopectus	NA
Chlorospingus flavipectus	Chlorospingus flavopectus	NA
Chlorospingus canigularis	Chlorospingus canigularis	NA
Chlorospingus flavigularis flavigularis	Chlorospingus flavigularis	NA
Chlorospingus flavigularis marginatus	Chlorospingus flavigularis	NA
Chlorospingus semifuscus	Chlorospingus semifuscus	NA
Hemispingus atropileus	Kleinothraupis atropileus	NA
Hemispingus rubrirostris	Cnemoscopus rubrirostris	NA
Hemispingus superciliaris superciliaris	Thlypopsis superciliaris	NA
Hemispingus superciliaris nigrifrons	Thlypopsis superciliaris	NA
Hemispingus frontalis oleagineus	Sphenopsis frontalis	NA
Hemispingus melanotis	Sphenopsis melanotis	NA
Pseudospingus verticalis	Pseudospingus verticalis	NA
Urothraupis stolzmanni	Urothraupis stolzmanni	NA
Psittospiza riefferi riefferi	Chlorornis riefferii	NA
Oreothraupis arremonops	Oreothraupis arremonops	NA
Cissopis leveriana minor	Cissopis leverianus	NA
Schistochlamys atra	Schistochlamys melanopis	NA
Zarhynchus wagleri wagleri	Psarocolius wagleri	NA
Gymnostinops guatimozinus	Psarocolius guatimozinus	NA
Gymnostinops yuracares	Psarocolius bifasciatus	NA
Ostinops decumanus	Psarocolius decumanus	NA
Ostinops salmoni	Psarocolius angustifrons	NA
Ostinops alfredi sincipitalis	Psarocolius angustifrons	NA
Ostinops alfredi neglectus	Psarocolius angustifrons	NA
Ostinops angustifrons	Psarocolius angustifrons	NA
Cacicus cela	Cacicus cela	NA
Cacicus vitellinus	Cacicus cela	NA
Cacicus leucorhamphus	Cacicus chrysonotus	NA
Cacicus haemorrhous affinus	Cacicus haemorrhous	NA
Cacicus uropygialis uropygialis	Cacicus uropygialis	NA
Cacicus uropygialis pacificus	Cacicus uropygialis	NA
Amblycercus solitarius	Cacicus solitarius	NA
Amblycercus holosericeus flavirostris	Amblycercus holosericeus	NA
Cassidix oryzivora violea	Molothrus oryzivorus	NA
Molothrus bonariensis atronitens	Molothrus bonariensis	NA
Molothrus bonariensis cabanisi	Molothrus bonariensis	NA
Molothrus bonariensis aequatorialis	Molothrus bonariensis	NA
Agelaius icterocephalus icterocephalus	Chrysomus icterocephalus	NA
Agelaius icterocephalus bogotensis	Chrysomus icterocephalus	NA
Leistes militaris	Leistes militaris	NA
Sturnella magna meridionalis	Sturnella magna	NA
Icterus spurius	Icterus spurius	NA
Icterus auricapillus	Icterus auricapillus	NA
Icterus mesomelas salvini	Icterus mesomelas	NA
Icterus giraudi	Icterus chrysater	NA
Icterus hondae	Icterus chrysater	NA
Icterus xanthornus xanthornus	Icterus nigrogularis	NA
Megaquiscalus major assimilis	Quiscalus mexicanus	NA
Macraglaeus subalaris	Macroagelaius subalaris	NA
Hypopyrrhus pyrohypogaster	Hypopyrrhus pyrohypogaster	NA
Cyanocorax affinis affinis	Cyanocorax affinis	NA
Cyanocorax violaceus	Cyanocorax violaceus	NA
Xanthoura yncas galeatus	Cyanocorax yncas	NA
Xanthoura yncas cyanodorsalis	Cyanocorax yncas	NA
Cyanolyca armillata quindiuna	Cyanolyca armillata	NA
Cyanolyca armillata armillata	Cyanolyca armillata	NA